11111
1P001
10001
10001
11111
