111111111111111111111
1P00000C1000000000001
100000000000000000001
1001111111111C1101111
1000000010001000000E1
100000000010000000001
111111111111111111111