111111111111111111111
1P00000C1000000000001
100000000000000000001
100111111110111111111
1000000C10000000000E1
111111111111111111111