111111111111111111111
1000000C10000000P0001
100000000000000000001
100111111110000000001
1000000C10000000000E1
111111111111111111111