1111111111
1C00000011
1000000001
1P000000E1
1111111111