1111111111
1000000011
1000000001
1P00000001
1111111111