111111111111111111111111
1P00000000010000000000C1
1000000000C1000000000001
101111111111011111111111
100010000000000000000001
10101M000000000000000001
101011011111111101111111
1E10000CCC00000000000001
111111111111111111111111
