111111111111111111111
1P001010001C100000001
101110101010101010101
100000001010101010101
101010101110101110111
101010101010000010101
111011111011101110101
101000100000000010001
101010101011101010111
100010101010101010101
101111111010111111101
101000100010100000001
101011101010111111101
100010001010100000001
101011101110101111101
101000000000101010101
101110111111111010101
101010000010000000001
101010101010111011101
1000101010001000001E1
111111111111111111111