11111111111111111111111111111111111111111
1P001000100000000000001000001000100000001
10111011101011111011101011111011111111101
100000100010000010001000100000101C0000001
10101010111010111011101010111110111011101
10101000101010100010001010101010001000101
11101110101111111111111110101011101110101
10101000000C10000000001000001000001000101
10101111111110111011101011101011111110101
10001000000000100010100010001000001000101
10111110111111101010111011101011111110111
10000000000010001000101000100000100000101
10111011111111111111101011111110101111101
10101000101000000000101010001010101010001
11101011101010101110101111101010101011101
10000000100010100010000000100010000010101
10111111111110101010111110101111101110101
10100000000000101010001000001000000000101
10111010101010101110101010101110111010101
10101010101010100010101010100010100010101
10101111101111111011111111101111101110101
10001000001000101000000M10000010001000001
10111011111011101111101110101110111111111
101000000000001000100000101C0000000000001
11101111111111111010111010111011111010101
10100010001000100000100010001000001010101
10111111101010111011101010111111101011111
10100000000C10101000101010000010101010001
10111110101110101111101111111110101110111
10100010101010000000000000001000101010001
10101011101011111110111011101110101010111
10101000101000101000001010000000101000001
10101011101011101010111110111111101011111
10001010000000100010000010000010001010001
11101110111110111111111011111110111011101
10100000001000001000000000000010000000001
10101111111111101111111010111011111011111
10001000000010100010000010101000001010001
10111010101110111011111011101011111110111
100010101000000000000010001000000000000E1
11111111111111111111111111111111111111111